.......................................................................................................................................
.......................................................................................................................................
.......................................................................................................................................
.......................................................................................................................................
.......................................................................................................................................
.......................................................................................................................................
.......................................................................................................................................
.......................................................................................................................................
.......................................................................................................................................
.............................#######################################################################################...................
.............................#######################################################################################...................
.............................#######################################################################################...................
.............................#######################################################################################...................
.............................#######################################################################################...................
.............................#######################################################################################...................
.............................#######################################################################################...................
.............................#######################################################################################...................
.............................#######################################################################################...................
.............................#######################################################################################...................
.............................#######################################################################################...................
.............................#######################################################################################...................
.............................#######################################################################################...................
.............................#######################################################################################...................
.............................#######################################################################################...................
.............................#######################################################################################...................
.............................#######################################################################################...................
.............................#######################################################################################...................
.............................#######################################################################################...................
.............................#######################################################################################...................
.............................#######################################################################################...................
.............................#######################################################################################...................
.............................#######################################################################################...................
.............................#######################################################################################...................
.............................#######################################################################################...................
.............................#######################################################################################...................
.............................#######################################################################################...................
.............................#######################################################################################...................
.............................#######################################################################################...................
.............................#######################################################################################...................
.............................#######################################################################################...................
.............................#######################################################################################...................
.............................#######################################################################################...................
.............................#######################################################################################...................
.............................#######################################################################################...................
.............................#######################################################################################...................
.............................#######################################################################################...................
.............................#######################################################################################...................
.............................#######################################################################################...................
.............................#######################################################################################...................
.............................#######################################################################################...................
.............................#######################################################################################...................
.............................#######################################################################################...................
.............................#######################################################################################...................
.............................#######################################################################################...................
.............................#######################################################################################...................
.............................#######################################################################################...................
.............................#######################################################################################...................
.............................#######################################################################################...................
.............................#######################################################################################...................
.............................#######################################################################################...................
.............................#######################################################################################...................
.............................#######################################################################################...................
.............................#######################################################################################...................
.............................#######################################################################################...................
.............................#######################################################################################...................
.............................#######################################################################################...................
.............................#######################################################################################...................
.............................#######################################################################################...................
.............................#######################################################################################...................
.............................#######################################################################################...................
.............................#######################################################################################...................
.............................#######################################################################################...................
.............................#######################################################################################...................
.............................#######################################################################################...................
.............................#######################################################################################...................
.............................#######################################################################################...................
.............................#######################################################################################...................
.............................#######################################################################################...................
.............................#######################################################################################...................
.............................#######################################################################################...................
.............................#######################################################################################...................
.............................#######################################################################################...................
.............................#######################################################################################...................
.............................#######################################################################################...................
.............................#######################################################################################...................
.............................#######################################################################################...................
.............................#######################################################################################...................
.............................#######################################################################################...................
.............................#######################################################################################...................
.............................#######################################################################################...................
.............................#######################################################################################...................
.............................#######################################################################################...................
.............................#######################################################################################...................
.............................#######################################################################################...................
.............................#######################################################################################...................
.............................#######################################################################################...................
.............................#######################################################################################...................
.............................#######################################################################################...................
.............................#######################################################################################...................
.............................#######################################################################################...................
.............................#######################################################################################...................
.............................#######################################################################################...................
.............................#######################################################################################...................
.............................#######################################################################################...................
.............................#######################################################################################...................
.............................#######################################################################################...................
.............................#######################################################################################...................
.............................#######################################################################################...................
.............................#######################################################################################...................
.............................#######################################################################################...................
.............................#######################################################################################...................
.............................#######################################################################################...................
.......................................................................................................................................
.......................................................................................................................................
.......................................................................................................................G...............
.......................................................................................................................................
.......................................................................................................................................
.......................................................................................................................................
.......................................................................................................................................
.......................................................................................................................................
.......................................................................................................................................
.......................................................................................................................................
.......................................................................................................................................
.......................................................................................................................................