#######################################
#S#.......#...#...........#...........#
#.#.#####.#.#.#.#########.#.#######.#.#
#...#...#...#.#.#.......#.#.#.....#...#
#####.#.#####.#.#.#####.#.#.#.###.#####
#...#.#.#.....#...#...#.#...#...#.....#
#.#.#.#.#.#######.###.#.#########.###.#
#.#.#...#.#.......#...#.#.........#...#
#.#.#####.#.#######.###...#######.###.#
#.#.#.....#.#...#...#...#.#...#...#...#
#.#.#####.#.#.#.#.###.###.#.#.#.#####.#
#...#...#...#.#.#...#...#...#.#.#.....#
#.###.###.###.#.#####.#####.###.#######
#.#...#...#...#.#...#.#...#.#...#.....#
#.#.#####.###.###.#.#.#.#.#.#.#######.#
#.#.#.....#...#...#.#.#.#.#.#.#.......#
#.#.#######.#####.###.#.#.#.#.#######.#
#.#.........#...#.....#...#.#.........#
#.#########.#.#######################.#
#...........#.......................#G#
#######################################